29 65
###### ##########################################################
###### #########                           ## # ### ##      #   #
######    ######                           #     #   # #### # # #
################                           # ##### #   #  # # ###
###     ########   ########## ##########   # #   # ###           
######     #####   ########## ##########   # # # ### # # # #### #
######   #######   ######         ######   #   # # # #####    # #
####   #  ######   ####             ####   ###          ####### #
#########    ###   ###               ###   # ##########      #  #
##        ######   ###               ###   # ####     # ####### #
## ## ##########   ##       # #       ##   # #  # # #   #  #  # #
## ##    #######   ##      ## ##      ##   # # ## ####### ## ## #
#   # ## ###  ##   ##     ### ###     ##   #           #        #
######## #######   ##    #### ####    ##   ########### # ### ## #
#####     ######             s                         ###   ## #
######### ######   ##    #### ####    ##   ########### #   ######
#     ### #   ##   ##     ### ###     ##   #   ##      # ###    #
# ##        # ##   ##      ## ##      ##   # #    # #### ########
###  ######  ###   ##       # #       ##   # ###### #  # #     ##
##  #####     ##   ###                ##   #   # ## ##     # ####
## ##     ##  ##   ###                ##   ### #     # ## ##    #
#####   ##### ##   ####              ###   #   #########   # ## #
###    ##    ###   #####           #####   # #   #    #  ### #  #
####      # ####   ########## ##########   # ### # #######   ## #
##   #### ## ###   ########## ##########   #     ###     ###### #
####### # ## # #                           # ######  ### #      #
    ###        #                           #           # ### # ##
###### #######                             # # # # #####     #  #
###### ##########################################################